111111111111111111111111111111111111111
100000000000010000000000000010000000001
100000000000000000000000000000000000001
100000100000010000010000000000000001001
100000000000000000000000000000000000001
100000000000000000000000000000000000001
100000000000000000000000000000000000001
111111111111111111111111111111111111111