NO ./textures/0.png
SO ./textures/1.png
WE ./textures/2.png
EA ./textures/3.png

F 60,0,0
C 090,060,060

        1111111111111111111111111
        1111000000000000000001111
        1111011111110111111101111
        1111011111110011111101111
        1111011111111001111101111
        1111011111111100111101111
        1111011111111110011101111
        1111011111111111001101111
        1111011111111111100001111
        1111011111111111111101111
        1111011111111111111101111
        1111011111111111111101111
        1111011111111111111101111
        1111011111111111111101111
        1111011111111111111101111
        1111011111111111111101111
        1111011111111111111101111
        1111011111111111111101111
        1111011111111111111101111
        1111011111111111111101111
        1000000000110000000000001
        1011000001110000000000001
        1001000000000000000000001
111111111011000001110000000000001 111
100000000011000001110111111111111
11110111111111011100000010001
11110111111111011101010010001
11000000110101010000000010001
10000000000001000100000010001
10000000000000001001010000001
11000001110101011011011110N0111
11110111 1110101 101111010001
11111111 1111111 111111111111
