111111111111111111111111111111111111111
100000001000000000000000000100000000001
111000111000000000000000000100000000001
100000000000000000010000000100001000001
100000000011101110000000000100001000001
100000000010000010000000100000001000001
100000000010000010000000000000001000001
111111111111111111111111111111111111111